deleterious	해로운, 유해한, has a harmful effect on it.
axiom	자명한 이치, 공리, 격언, a statement or idea which people accept as being true.
deliberate	고의의, 의도적인, done consciously and intentionally
cockpit door	a compartment for the pilot
courteous	polite, respectful, considerate in manner
banter	talk or exchange remarks in a good humored teasing way.
distress	extreme anxiety, sorrow, or pain
assertion	a confident and forceful statement of fact or belief
commit	carry out or perpetrate
interior minister	내무부 장관, a head of interior ministry
legimate	confirming tot he law or to rules
magnitude	the great size or sextent of something
explicit	stated clearly and in detail, leaving no room for confusion or doubt
agrarian	농업의, ager, agri:
agriculture	농업
amity	우호, 친선, amo:
filiation	친자관계, 계통, 유래, filius:
affiliation	소속, 가맹, 제휴
affiliate	제휴하다, 가입하다, 연계되다, 계열사
filial	(부모에 대한) 자식의
hidalgo	스페인 하급 귀족
aboveboared	공명정대하게, 공명정대한, 훤히 보이는
ruthless	무자비한, 가차없는
dog eat dog	골육상쟁, 치열한 경쟁, 치열하게 다투는
conceit	자만심, 기발하긴 하지만 성공적이지 못한 효과, 기발한 비유
egotist	자기중심주의자, 자존가, 이기주의자
amorous	육체적인 애정을 보이는
conquest	정복, 점령지